{
    "name": "DZ60",
    "vendorProductId": 1146757728,
    "macros": ["", "", "", "", "", "", "", "", "", "", "", "", "", "", "", ""],
    "layers": [
        [
            "KC_GESC",
            "KC_1",
            "KC_2",
            "KC_3",
            "KC_4",
            "KC_5",
            "KC_6",
            "KC_7",
            "KC_8",
            "KC_9",
            "KC_0",
            "KC_MINS",
            "KC_EQL",
            "KC_GRV",
            "KC_BSPC",
            "KC_TAB",
            "KC_NO",
            "KC_Q",
            "KC_W",
            "KC_E",
            "KC_R",
            "KC_T",
            "KC_Y",
            "KC_U",
            "KC_I",
            "KC_O",
            "KC_P",
            "KC_LBRC",
            "KC_RBRC",
            "KC_BSLS",
            "KC_CAPS",
            "KC_NO",
            "KC_A",
            "KC_S",
            "KC_D",
            "KC_F",
            "KC_G",
            "KC_H",
            "KC_J",
            "KC_K",
            "KC_L",
            "KC_SCLN",
            "KC_QUOT",
            "KC_ENT",
            "KC_NO",
            "KC_LSFT",
            "KC_NUBS",
            "KC_Z",
            "KC_X",
            "KC_C",
            "KC_V",
            "KC_B",
            "KC_N",
            "KC_M",
            "KC_COMM",
            "KC_DOT",
            "KC_SLSH",
            "KC_RSFT",
            "KC_RSFT",
            "KC_DEL",
            "KC_LCTL",
            "KC_LGUI",
            "KC_NO",
            "KC_LALT",
            "KC_F1",
            "KC_NO",
            "KC_SPC",
            "KC_NO",
            "KC_F2",
            "KC_NO",
            "KC_RALT",
            "KC_RGUI",
            "KC_LEFT",
            "MO(3)",
            "KC_RCTL"
        ],
        [
            "KC_TRNS",
            "KC_TRNS",
            "KC_TRNS",
            "KC_TRNS",
            "KC_TRNS",
            "KC_TRNS",
            "KC_TRNS",
            "KC_TRNS",
            "KC_TRNS",
            "KC_TRNS",
            "KC_TRNS",
            "KC_TRNS",
            "KC_TRNS",
            "KC_TRNS",
            "KC_TRNS",
            "KC_TRNS",
            "KC_NO",
            "KC_TRNS",
            "KC_TRNS",
            "KC_TRNS",
            "KC_TRNS",
            "KC_TRNS",
            "KC_TRNS",
            "KC_TRNS",
            "KC_TRNS",
            "KC_TRNS",
            "KC_TRNS",
            "KC_TRNS",
            "KC_TRNS",
            "KC_TRNS",
            "KC_LCTL",
            "KC_NO",
            "KC_TRNS",
            "KC_TRNS",
            "KC_TRNS",
            "KC_TRNS",
            "KC_TRNS",
            "KC_TRNS",
            "KC_TRNS",
            "KC_TRNS",
            "KC_TRNS",
            "KC_TRNS",
            "KC_TRNS",
            "KC_TRNS",
            "KC_NO",
            "KC_TRNS",
            "KC_TRNS",
            "KC_TRNS",
            "KC_TRNS",
            "KC_TRNS",
            "KC_TRNS",
            "KC_TRNS",
            "KC_TRNS",
            "KC_TRNS",
            "KC_TRNS",
            "KC_TRNS",
            "KC_TRNS",
            "KC_TRNS",
            "KC_TRNS",
            "KC_TRNS",
            "MO(3)",
            "KC_LALT",
            "KC_NO",
            "KC_LGUI",
            "KC_TRNS",
            "KC_NO",
            "KC_TRNS",
            "KC_NO",
            "KC_TRNS",
            "KC_NO",
            "KC_RGUI",
            "KC_RALT",
            "KC_TRNS",
            "KC_TRNS",
            "KC_RCTL"
        ],
        [
            "KC_TRNS",
            "MACRO00",
            "MACRO01",
            "KC_TRNS",
            "KC_TRNS",
            "KC_TRNS",
            "KC_TRNS",
            "KC_TRNS",
            "KC_TRNS",
            "KC_TRNS",
            "KC_TRNS",
            "KC_TRNS",
            "KC_TRNS",
            "S(KC_NO)",
            "KC_TRNS",
            "KC_TRNS",
            "C(KC_NO)",
            "KC_TRNS",
            "KC_TRNS",
            "KC_TRNS",
            "KC_TRNS",
            "KC_TRNS",
            "KC_TRNS",
            "KC_TRNS",
            "KC_TRNS",
            "KC_TRNS",
            "KC_TRNS",
            "KC_TRNS",
            "KC_TRNS",
            "KC_TRNS",
            "KC_TRNS",
            "A(LWIN(KC_B))",
            "KC_TRNS",
            "KC_TRNS",
            "KC_TRNS",
            "KC_TRNS",
            "KC_TRNS",
            "KC_TRNS",
            "KC_TRNS",
            "KC_TRNS",
            "KC_TRNS",
            "KC_TRNS",
            "KC_TRNS",
            "KC_TRNS",
            "KC_NO",
            "KC_TRNS",
            "C(KC_R)",
            "KC_TRNS",
            "KC_TRNS",
            "MACRO02",
            "KC_TRNS",
            "KC_TRNS",
            "KC_TRNS",
            "KC_TRNS",
            "KC_TRNS",
            "KC_TRNS",
            "KC_TRNS",
            "KC_NO",
            "KC_TRNS",
            "KC_NO",
            "MO(3)",
            "KC_TRNS",
            "KC_NO",
            "KC_TRNS",
            "C(A(LCA(KC_FN0)))",
            "C(LWIN(KC_TRNS))",
            "KC_TRNS",
            "KC_NO",
            "C(A(LCA(KC_B)))",
            "C(LWIN(RCTL(RWIN(KC_D))))",
            "KC_TRNS",
            "KC_TRNS",
            "KC_NO",
            "MO(3)",
            "KC_TRNS"
        ],
        [
            "KC_GRV",
            "KC_F1",
            "KC_F2",
            "KC_F3",
            "KC_F4",
            "KC_F5",
            "KC_F6",
            "KC_F7",
            "KC_F8",
            "KC_F9",
            "KC_F10",
            "KC_F11",
            "KC_F12",
            "MT(MOD_LCTL | MOD_LALT | MOD_RCTL | MOD_RALT,KC_B)",
            "KC_DEL",
            "KC_TRNS",
            "MT(MOD_LCTL | MOD_LALT | MOD_RCTL | MOD_RALT,KC_TRNS)",
            "KC_HOME",
            "KC_UP",
            "KC_END",
            "KC_TRNS",
            "KC_TRNS",
            "KC_TRNS",
            "KC_TRNS",
            "KC_TRNS",
            "KC_TRNS",
            "KC_MPLY",
            "KC_MPRV",
            "KC_MNXT",
            "KC_TRNS",
            "KC_TRNS",
            "KC_NO",
            "KC_LEFT",
            "KC_DOWN",
            "KC_RGHT",
            "KC_TRNS",
            "KC_TRNS",
            "KC_TRNS",
            "KC_TRNS",
            "KC_TRNS",
            "KC_MUTE",
            "KC_VOLD",
            "KC_VOLD",
            "KC_TRNS",
            "LWIN(KC_LANG6)",
            "KC_TRNS",
            "S(KC_NO)",
            "KC_TRNS",
            "KC_TRNS",
            "KC_TRNS",
            "KC_TRNS",
            "KC_TRNS",
            "KC_TRNS",
            "KC_TRNS",
            "TO(0)",
            "TO(1)",
            "TO(2)",
            "KC_NO",
            "KC_CAPS",
            "C(LWIN(RCTL(RWIN(KC_E))))",
            "KC_TRNS",
            "KC_TRNS",
            "MT(MOD_LCTL | MOD_LALT | MOD_RCTL | MOD_RALT,KC_B)",
            "KC_TRNS",
            "KC_NO",
            "MT(MOD_LCTL | MOD_LALT | MOD_RCTL | MOD_RALT,KC_TRNS)",
            "KC_TRNS",
            "KC_NO",
            "S(KC_F)",
            "KC_P3",
            "KC_TRNS",
            "KC_TRNS",
            "C(LWIN(KC_MS_WH_DOWN))",
            "KC_TRNS",
            "KC_TRNS"
        ]
    ]
}
